0	_empty_
1	_dummy_
2	_sink_
3	_unseen_
4	AAFS1----1A----
5	AAFS4----1A----
6	AAIS1----1A----
7	AAIS2----1A----
8	AAIS4----1A----
9	AAMS1----1A----
10	AANS2----1A----
11	C--------------
12	ClFS1----------
13	ClXP1----------
14	ClXP4----------
15	ClYP1----------
16	ClYP4----------
17	Cn-P2----------
18	Cn-S1----------
19	Cn-S4----------
20	CrFS2----------
21	CrIS2----------
22	Db-------------
23	Dg-------1A----
24	Dg-------2A----
25	II-------------
26	J--------------
27	NNFP1-----A----
28	NNFP2-----A----
29	NNFP4-----A----
30	NNFS1-----A----
31	NNFS2-----A----
32	NNFS4-----A----
33	NNFS6-----A----
34	NNIP1-----A----
35	NNIP2-----A----
36	NNIP4-----A----
37	NNIS1-----A----
38	NNIS2-----A----
39	NNIS4-----A----
40	NNIS6-----A----
41	NNIS7-----A----
42	NNMS1-----A----
43	NNMS4-----A----
44	NNMS5-----A----
45	NNNS1-----A----
46	NNNS2-----A----
47	NNNS4-----A----
48	NNNS6-----A----
49	P7-X4----------
50	PDIS4----------
51	PDNS1----------
52	PDNS4----------
53	PDXP2----------
54	PDYS1----------
55	PH-S3--1-------
56	PP-P3--2-------
57	PP-P4--2-------
58	PP-S1--1-------
59	PZIS4----------
60	RR--2----------
61	RR--4----------
62	RR--6----------
63	RR--7----------
64	RV--2----------
65	RV--4----------
66	RV--6----------
67	TT-------------
68	VB-P---2F-AA---
69	VB-P---2P-AA---
70	VB-P---3P-AA---
71	VB-S---1P-AA---
72	VB-S---1P-NA---
73	VB-S---3F-AA---
74	VB-S---3P-AA---
75	VB-S---3P-NA---
76	Vc-P---2-------
77	Vc-S---1-------
78	Vc-X---3-------
79	Vf--------A----
80	VpNS---XR-AA---
81	VpQW---XR-AA---
82	VpYS---XR-AA---
